0 0 0 0 0 0 0 0 0 0 1 0 0 0 1 0 0 0 0 0 0 0 0 0 0 
0 0 0 0 1 2 0 0 0 0 0 0 0 0 0 0 0 0 0 2 1 0 0 0 0 
2 2 0 5 1 0 0 0 0 0 2 5 0 5 2 0 0 0 0 0 1 5 0 2 2 
2 2 0 2 1 0 2 0 0 0 0 0 0 0 0 0 0 0 2 0 1 2 0 2 2 
2 2 0 0 0 0 1 0 0 0 0 0 0 0 0 0 0 0 1 0 0 0 0 2 2 
2 2 0 0 2 1 1 2 0 0 0 0 0 0 0 0 0 2 1 1 2 0 0 2 2 
0 0 0 2 1 5 2 0 0 0 0 0 3 0 0 0 0 0 2 5 1 2 0 0 0 
0 0 0 0 1 0 2 0 0 0 0 2 1 2 0 0 0 0 2 0 1 0 0 0 0 
2 2 2 0 2 1 2 0 2 1 1 1 5 1 1 1 2 0 2 1 2 0 2 2 2 
2 2 0 0 0 0 0 0 0 0 1 0 0 0 1 0 0 0 0 0 0 0 0 2 2 
2 2 0 2 5 2 1 2 0 2 2 1 0 1 2 2 0 2 1 2 5 2 0 2 2 
2 2 0 2 0 2 0 1 0 1 0 1 1 1 0 1 0 1 0 2 0 2 0 2 2 
0 0 0 1 0 1 0 1 2 1 1 1 0 1 1 1 2 1 0 1 0 1 0 0 0 
0 0 0 0 0 0 0 0 1 0 0 1 5 1 0 0 1 0 0 0 0 0 0 0 0 
2 2 2 2 2 2 2 2 2 2 2 2 2 2 2 2 2 2 2 2 2 2 2 2 2 
